=====================================================
=====================================================
=====================================================
=========######################======================
=========#?#######.....########============
=========#.######..#.#........@=================
=========#.#######...####.....#=================
=========#.#.####..#.##.#######======================
=========#.#..#...##......-#..#======================
=========#.#.##.####.##.##.#.##======================
=========#......###.....####..#===============
=========######################=========
=====================================================
=====================================================
=====================================================